111111111111111111111111111111111111111111111111111111111111
1000C0010011111111111111111111111111111111111111111111111111
1000E00P0011111111111111111111111111111111111111111111111111
100000010011111111111111111111111111111111111111111111111111
100000010011111111111111111111111111111111111111111111111111
100000010011111111111111111111111111111111111111111111111111
100000010011111111111111111111111111111111111111111111111111
100000010011111111111111111111111111111111111111111111111111
100000010011111111111111111111111111111111111111111111111111
100000010011111111111111111111111111111111111111111111111111
100000010011111111111111111111111111111111111111111111111111
100000010011111111111111111111111111111111111111111111111111
100000010011111111111111111111111111111111111111111111111111
100000010011111111111111111111111111111111111111111111111111
100000010011111111111111111111111111111111111111111111111111
100000010011111111111111111111111111111111111111111111111111
100000010011111111111111111111111111111111111111111111111111
100000010011111111111111111111111111111111111111111111111111
100000010011111111111111111111111111111111111111111111111111
100000010011111111111111111111111111111111111111111111111111
100000010011111111111111111111111111111111111111111111111111
100000010011111111111111111111111111111111111111111111111111
100000010011111111111111111111111111111111111111111111111111
100000010011111111111111111111111111111111111111111111111111
100000010011111111111111111111111111111111111111111111111111
100000010011111111111111111111111111111111111111111111111111
100000110011111111111111111111111111111111111111111111111111
100000010011111111111111111111111111111111111111111111111111
111111111111111111111111111111111111111111111111111111111111
